R 1900 900
SO tex/purplestone.xpm
NO tex/greystone.xpm
WE tex/redbrick.xpm
EA tex/wood.xpm
S tex/kit.xpm
C 0,15,0
F 2,100,0
   
        1111111111111111111111111
        1000000000110000000000001
        1011000001110000002000001
        1001000000000000000000001
111111111011000001110000000000001
100000000011000001110111100011111
11110111111111011100000010001
11110111111111011101010010001
11000000110101011100000010001
10002000000000001100000010001
10000000002000001101010010001
11000001110101011111011110S0111
11110111 1110101 101111010001
11111111 1111111 111111111111